10 10 20 10
-1 0 0 S 0 0 0 0 -1 0 
0 0 -1 0 0 0 0 0 0 0 
0 -1 0 0 0 0 0 0 0 0 
0 0 0 0 0 0 -1 -1 0 -1
-1 0 0 0 0 -1 0 0 0 0 
0 0 0 0 0 0 -1 0 0 0 
-1 0 0 0 -1 -1 G 0 -1 0 
0 0 0 0 0 0 0 0 0 0 
0 0 0 0 0 0 0 0 0 0 
0 0 0 -1 -1 -1 0 0 0 0 
