12 12 35 10
0 0 0 0 -1 -1 0 0 1 0 0 0 
0 S 0 100 G 0 0 -1 0 -1 0 0 
0 0 -1 -1 -1 0 0 -1 0 -1 0 0
0 0 0 0 -1 0 15 -1 0 0 0 0 
0 0 -1 -1 -1 -1 0 -1 -1 0 -1 0 
1 0 -1 0 0 0 0 0 -1 0 -1 0 
0 0 0 0 -1 4 -1 2 -1 0 -1 0 
0 0 0 0 -1 0 0 0 0 0 -1 0 
0 -1 -1 -1 -1 0 0 0 0 0 -1 0 
0 0 5 0 0 0 -1 -1 -1 0 -1 0 
0 0 -1 -1 -1 0 0 -1 0 -1 -1 0 
0 0 0 0 -1 0 0 -1 0 0 0 0 